9 10
01m0110110
0000000000
1001111001
1001011001
1101000001
1000011001
1001111001
1001c11001
1101000001
